@@@@@@@@@@@@@@@@@@@@@@@@@@@@@@@@@@@@@@@
@@@@@@@@@@@@@@@@@@@@@@@@@@@@@@@@@@@@@@@
@@@@·@@@@@@@@@@@@@@@@@@@@@@@@@@@@@@@@@@
@@@@·······························@@@@
@@@@··················°············@@@@
@@@@·······························@@@@
@@@@···········**°···········|·····@@@@
@@@@···········**···°········|·····@@@@
@@@@····°······**············|·····@@@@
@@@@···········**············|·····@@@@
@@@@···········**············|·····@@@@
@@@@·······********··········|·····@@@@
@@@@·························|·····@@@@
@@@@·························|·····@@@@ 
@@@@··················°······|·····@@@@
@@@@···°°°°··················|·····@@@@
@@@@··············°··········|·····@@@@
@@@@@@@@@@@@@@@@@@@@@@@@@@@@@@@@@@@@@@@
@@@@@@@@@@@@@@@@@@@@@@@@@@@@@@@@@@@@@@@
@@@@@@@@@@@@@@@@@@@@@@@@@@@@@@@@@@@@@@@